Capture                  =  bool __cdecl Capture(int,enum CaptureFlags);
CaptureDir               =  struct FileName __cdecl CaptureDir(void);
ComCTS                   =  bool __cdecl ComCTS(int);
CurrentFile              =  struct FileName __cdecl CurrentFile(void);
DataScanAngle            =  double __cdecl DataScanAngle(void);
DataScanRate             =  double __cdecl DataScanRate(void);
DataSetpoint             =  double __cdecl DataSetpoint(void);
DoFeatureEngage          =  int __cdecl DoFeatureEngage(void);
DoHeightEngage           =  int __cdecl DoHeightEngage(void);
DoZoomIn                 =  void __cdecl DoZoomIn(void);
DoZoomOut                =  void __cdecl DoZoomOut(void);
Engage                   =  bool __cdecl Engage(void);
EraseMessage             =  void __cdecl EraseMessage(void);
FrameDown                =  void __cdecl FrameDown(void);
FrameUp                  =  void __cdecl FrameUp(void);
GetAspectRatio           =  float __cdecl GetAspectRatio(void);
GetDir                   =  struct FileName __cdecl GetDir(struct FileName &);
GetDirectionScanned      =  float __cdecl GetDirectionScanned(void);
GetDriveFreq             =  float __cdecl GetDriveFreq(void);
GetEngageStatus          =  int __cdecl GetEngageStatus(void);
GetIntegralGain          =  double __cdecl GetIntegralGain(void);
GetSamplesPerLine        =  int __cdecl GetSamplesPerLine(void);
GetScanAngle             =  float __cdecl GetScanAngle(void);
GetScanLines             =  int __cdecl GetScanLines(void);
GetScanRate              =  float __cdecl GetScanRate(void);
GetScanSize              =  float __cdecl GetScanSize(void);
GetSetpoint              =  double __cdecl GetSetpoint(void);
GetStartupPath           =  void __cdecl GetStartupPath(struct FileName &);
GetXOffset               =  float __cdecl GetXOffset(void);
GetYOffset               =  float __cdecl GetYOffset(void);
ImageMode                =  void __cdecl ImageMode(void);
IsCaptureDone            =  bool __cdecl IsCaptureDone(void);
IsClosedLoop             =  bool __cdecl IsClosedLoop(void);
IsEngaged                =  bool __cdecl IsEngaged(void);
IsRealTime               =  bool __cdecl IsRealTime(void);
IsTappingMode            =  bool __cdecl IsTappingMode(void);
IsTipExchange            =  bool __cdecl IsTipExchange(void);
LastCapturedFileName     =  struct FileName __cdecl LastCapturedFileName(void);
LithoAbort               =  void __cdecl LithoAbort(void);
MacroAbort               =  void __cdecl MacroAbort(char *);
MakeFileName             =  struct FileName __cdecl MakeFileName(char *);
ModifyFileName           =  bool __cdecl ModifyFileName(struct FileName &,char *);
NextSite                 =  int __cdecl NextSite(void *);
NextTipSite              =  int __cdecl NextTipSite(void *,struct Coord3D &,struct FileName &,bool &,int &);
RealTime                 =  void __cdecl RealTime(void);
RegisterSite             =  bool __cdecl RegisterSite(void *);
RegisterSite             =  bool __cdecl RegisterSite(class SiteHandle);
SaveFile                 =  void __cdecl SaveFile(void);
ScopeMode                =  void __cdecl ScopeMode(void);
SetAFMMode               =  void __cdecl SetAFMMode(enum AFMMode);
SetAspectRatio           =  void __cdecl SetAspectRatio(float);
SetCaptureFileName       =  void __cdecl SetCaptureFileName(struct FileName &);
SetCurrentDir            =  void __cdecl SetCurrentDir(struct FileName &);
SetExtraSiteInfo         =  void __cdecl SetExtraSiteInfo(void *,struct ExtraSiteInfo &);
SetIntegralGain          =  void __cdecl SetIntegralGain(double);
SetInterleaveMode        =  void __cdecl SetInterleaveMode(bool);
SetProportionalGain      =  void __cdecl SetProportionalGain(double);
SetSamplesPerLine        =  void __cdecl SetSamplesPerLine(int);
SetScanAngle             =  void __cdecl SetScanAngle(float);
SetScanLines             =  void __cdecl SetScanLines(int);
SetScanRate              =  void __cdecl SetScanRate(float);
SetScanSize              =  void __cdecl SetScanSize(float);
SetScanSizeOffLine       =  void __cdecl SetScanSizeOffLine(float);
SetSetpoint              =  void __cdecl SetSetpoint(double);
SetXOffset               =  void __cdecl SetXOffset(float);
SetYOffset               =  void __cdecl SetYOffset(float);
ShowMessage              =  void __cdecl ShowMessage(char const *,char const *,...);
SiteFileClose            =  void __cdecl SiteFileClose(void *,bool);
SiteFileEdit             =  bool __cdecl SiteFileEdit(void *);
SiteFileIndex            =  int __cdecl SiteFileIndex(void *);
SiteFileOpen             =  void * __cdecl SiteFileOpen(struct FileName const &);
SiteFileReset            =  void __cdecl SiteFileReset(void *);
StageGetMaxSpeed         =  float __cdecl StageGetMaxSpeed(enum StageAxisCodes);
StageGetPosition         =  float __cdecl StageGetPosition(int);
StageGetSpeed            =  float __cdecl StageGetSpeed(enum StageAxisCodes);
StageGetXYZ              =  struct Coord3D __cdecl StageGetXYZ(void);
StageGetXYZReference     =  int __cdecl StageGetXYZReference(long &,long &,long &,long &,long &);
StageMove3D              =  bool __cdecl StageMove3D(void *,struct Coord3D &,bool);
StageMoveAxis            =  bool __cdecl StageMoveAxis(int,float,bool,int,float,bool);
StageMoveSPM             =  bool __cdecl StageMoveSPM(float,bool);
StageMoveTo              =  void __cdecl StageMoveTo(void);
StageMoveToSurfaceFocus  =  bool __cdecl StageMoveToSurfaceFocus(void);
StageRegister            =  bool __cdecl StageRegister(void *,bool);
StageResetImageCenter    =  void __cdecl StageResetImageCenter(void);
StageSetXYReference      =  void __cdecl StageSetXYReference(int,long,long,long,long);
StageSetXYZReference     =  void __cdecl StageSetXYZReference(int,long,long,long,long,long);
StageUnload              =  void __cdecl StageUnload(void);
StartCapture             =  bool __cdecl StartCapture(int,enum CaptureFlags);
StartNewThread           =  void __cdecl StartNewThread(void (__cdecl*)(void));
ThreadAttach             =  void __stdcall ThreadAttach(void);
ThreadDetach             =  void __stdcall ThreadDetach(void);
TimeString               =  char * __cdecl TimeString(void);
UserSetXmasTree          =  void __cdecl UserSetXmasTree(enum XmasLightType);
UserXmasTreeNumLights    =  int __cdecl UserXmasTreeNumLights(void);
WaitForCapture           =  bool __cdecl WaitForCapture(void);
Withdraw                 =  bool __cdecl Withdraw(void);
getSecsOnLine            =  bool __cdecl getSecsOnLine(void);
popMessage               =  void __cdecl popMessage(struct SDRMSG *,unsigned short *,char *,long);
pushMessage              =  void __cdecl pushMessage(struct SDRMSG *,unsigned short *,char * *);
secsActive               =  bool __cdecl secsActive(void);
setReportLocation        =  void __cdecl setReportLocation(char *,int,int);
takeABreak               =  void __cdecl takeABreak(void);